NO ./textures/eagle.xpm
SO ./textures/greystone.xpm
WE ./textures/tonneau.xpm
EA ./textures/purplestone.xpm

F 255,204,204
C 255,178,102

1111111111
1001000001
1010001101
1100N00001
1000000001
1000000001
1111111111
